WE ./assets/beach.png
SO ./assets/computer.png
NO ./assets/small.png
EA ./assets/skay.png

C 0,150,80
F 150,150,150

1111111111
1001000101
1001000001
10010N0001
1001000101
1001000101
1001000101
1111111111
