                                                                                                                                                                                                                                                                                                                                                                                                                                                                                                                                                                                                                                                                                                                                                                                                                                                                                                                                                                                                NO ./assets/computer.png
SO ./assets/small.png


































































WE ./assets/beach.png

































C 150,150,150
EA ./assets/skay.png

















































































































































F 255,255,255
11111
10101
11S11
10101
11111
