NO ./assets/computer.png
SO ./assets/cofee.png
WE ./assets/beach.png
EA ./assets/skay.png

C 150,150,150
F 255,255,255

11111
10101
11E11
10101
11111
