                                                                                                                                                                                                                                                                                                                                                                                                                                                                                                                                                                                                                                                                                                                                                                                                                                                                                                                                                                                                NO ./assets/computer.png
SO ./assets/cofee.png


































































WE ./assets/beach.png

































C 150,150,150
EA ./assets/skay.png

















































































































































F 255,255,255
11111
10001
10E01
10001
11111
