NO ./assets/computer.png
SO ./assets/small.png
WE ./assets/beach.png
EA ./assets/skay.png

C 150,150,150
F 255,69,0


11111
10101
10111
10E01
10001
11111
