WE ./assets/beach.png
SO ./assets/computer.png
NO ./assets/small.png
EA ./assets/skay.png

C 0,15,80
F 150,150,150

1111111101
1001000101
1001000001
10010N0101
1001000101
1001000101
1001000101
1111111101
