                                                                                                                                                                                                                                                                                                                                                                                                                                                                                                                                                                                                                                                                                                                                                                                                                                                                                                                                                                                                NO ./assets/computer.png
SO ./assets/small.png


































































WE ./assets/beach.png

































C 150,150,150
EA ./assets/skay.png

















































































































































F 255,69,0






























11111
10101
11111
11E11
10101
11111
