
C 0,0,80

NO                                  ./assets/computer.png
SO ./assets/coffee.png
WE ./assets/small.png
EA ./assets/skay.png

F 150,150,15

1111111111111111111111111
1000000000110000000000001
1011000001110000000000001
100100000100000000000000111111111
111111111011000001111000000000001
100000000011000001110111111111111
11111111111111111100000010001
11110111111111011101010010001
11000000110101011100000010001
10000000000000001100000010001
10000000000000001101000010001
11000001110101011111111110W0111
11110111 1110101 101000000001
11111111 1111111 111111111111
