WE ./maps/texture/path_to_the_north_texture
SO ./maps/texture/path_to_the_north_texture
NO ./maps/texture/path_to_the_north_texture
EA ./maps/texture/path_to_the_north_texture

C 0,0,0
F 225,30,0

1111111111111111111111111
100001000110000000000001
1011000001110000000000001
1001000000000000000000001
111111111011000001110000000000001
100000000011000001110111111111111
11110111111111011100000010001
11110111111111011101010010001
11000000110101011100000010001
1000000000000000110000010001
1000000000000000010101001N001
1100000111010101111101111000111
11110111 1110101 101111010001
11111111 1111111 111111111111
