WE ./assets/beach.png
SO ./assets/computer.png
NO ./assets/small.png
EA ./assets/skay.png

C 0,15,80
F 150,150,150

11111111111          1111111111
10000000001111111111100000000001
1E000000000000000000000000000001
11000000111111111111100000000001
11101110000011000000000000000001
  101111100000001011111000010001
  1001111000010000111111100000011111
111000000000001111      1111000000011
1111011111101111            1000000001   111111
1100000000101                111100000111100001
 100000100101                    11000000000001
 100100100001                      111111111101
 1100000001111111111111111111111111111111111111
   100000000000000000000000000000000000000000001
    11111111111111111111111110000000001000000001
                            10000000000011000001
                            10110001000011000001
                            10010000000000000001
                            10000100000100000001
                            10000000000000000001
                            11111111111111111111
